-7
8
-5
11
0000000000000000
1111111111111110
1111111111111110
1112111221112110
1112111221112110
1111111221122110
1111111221121110
1111111221121110
1111111221121110
1111111221121110
1111111221121110
1111111221121110
1111111221122110
1112111221112110
1112111111112110
1111111111111110
1111111111111110
